NO ./assets/north_texture.xpm


SO ./assets/south_texture.xpm
EA ./assets/east_texture.xpm

WE ./assets/west_texture.xpm
F 220,100,0


C 255,255,0

        11111111111
        11000000011                   11111111
        11000000011                   10000001
1111111111000000011111111111111111111110000001
1000000000000000000000000000000000000000000001
1000000000000000000000001111111111111111111111
1000000N00000000000000001
1000000000000000000000001
1000000000000000000000001
1000000000000000000000001
1000000000000000000000001
1000000000000000000000001
1000000000000000000000001
1000000000000000000000001
1000000000000000000000001
1111111111111111111111111
