NO ./path_to_the_north_texture


SO ./path_to_the_south_texture
EA ./path_to_the_east_texture



WE ./path_to_the_west_texture

F 220,100,0


C 225,30,0

        11110111111
        11000000011
        11000000011
1111111111000000011111111
1000000000000000000000001
1000000000000000000000001
1000000000000000000000001
1000000000000000000000001
1000000000000000000000001
1000000000000000000000001
1000000000000000000000001
1000000000000000000000001
1000000000000000000000001
1000000000000000000000001
1000000000000000000000001
1111111111111111111111111
