NO ./path_to_the_north_texture


SO ./path_to_the_south_texture
EA ./path_to_the_east_texture



WE ./path_to_the_west_texture

F 220,100,0


C 225,30,0

        11111111111                           
        11000000011                   11101111
        11000000011                   10000001
1111111111000000011111111111111111111110000001
1000000000000000000000000000000000000000000001
1000000000000000000000001111111111111111111111
1000000000000000000000001
1000000000000000000000001
1000000000000000000000001
1000000000000000000000001
1000000000000000000000001
1000000000000000000000001
1000000000000000000000001
1000000000000000000000001
1000000000000000000000001
1111111111111111111111111
