NO ../assets/north_texture.xpm


SO ../assets/south_texture.xpm
EA ../assets/east_texture.xpm

WE ../assets/west_texture.xpm

F 220,100,0


C 225,30,0



1111111111111111111111
1111111111100000001111111
1000000000110000000000001
1011100111110000000000001
10010000110000N0000000000111111111
111111111011000001110000000000001
1111111111111111111111111111111111111111
11110111111111011100000010001
11110111111111011101010010001
11000000110101011100000010001
1000000000000000110000010001
10000000000000001101010010001
1100000111010101111101111000111
11110111 1110101 101111010001
11111111 1111111 111111111111
