NO ../assets/north_texture.xpm


SO ../assets/south_texture.xpm
EA ../assets/east_texture.xpm

WE ../assets/west_texture.xpm

F 100,100,100


C 255,255,0



1111111111111111111111
1000000000000000000001
1000000000000000000001
1000000000000000000001
1000000000000000000001
1000000010001000000001
1000000010001000000001
1000000000001000000001
1000000000001000000001
1000000010001000000001
1000000000001000000001
1000000010001000000001
1000000000N00000000001
1000000000000000000001
1000000000000000000001
1111111111111111111111
